!"	['blake-poems.txt']
"	['blake-poems.txt']
'	['austen-emma.txt', 'blake-poems.txt', 'edgeworth-parents.txt', 'milton-paradise.txt', 'whitman-leaves.txt']
(	['melville-moby_dick.txt', 'shakespeare-caesar.txt', 'whitman-leaves.txt']
)	['melville-moby_dick.txt', 'shakespeare-caesar.txt']
,	['austen-emma.txt', 'bible-kjv.txt', 'blake-poems.txt', 'chesterton-ball.txt', 'chesterton-thursday.txt', 'edgeworth-parents.txt', 'melville-moby_dick.txt', 'milton-paradise.txt', 'shakespeare-caesar.txt', 'whitman-leaves.txt']
,)	['whitman-leaves.txt']
-	['austen-emma.txt', 'whitman-leaves.txt']
--	['chesterton-thursday.txt', 'melville-moby_dick.txt', 'whitman-leaves.txt']
.	['austen-emma.txt', 'bible-kjv.txt', 'blake-poems.txt', 'chesterton-ball.txt', 'chesterton-thursday.txt', 'edgeworth-parents.txt', 'melville-moby_dick.txt', 'milton-paradise.txt', 'shakespeare-caesar.txt', 'whitman-leaves.txt']
."	['blake-poems.txt']
:	['bible-kjv.txt', 'blake-poems.txt', 'chesterton-thursday.txt', 'milton-paradise.txt', 'shakespeare-caesar.txt']
:!"	['blake-poems.txt']
;	['austen-emma.txt', 'bible-kjv.txt', 'blake-poems.txt', 'chesterton-ball.txt', 'chesterton-thursday.txt', 'edgeworth-parents.txt', 'melville-moby_dick.txt']
;"	['blake-poems.txt']
?	['shakespeare-caesar.txt']
[	['austen-emma.txt', 'bible-kjv.txt', 'blake-poems.txt', 'chesterton-ball.txt', 'chesterton-thursday.txt', 'edgeworth-parents.txt', 'melville-moby_dick.txt', 'milton-paradise.txt', 'shakespeare-caesar.txt', 'whitman-leaves.txt']
]	['austen-emma.txt', 'bible-kjv.txt', 'blake-poems.txt', 'chesterton-ball.txt', 'chesterton-thursday.txt', 'edgeworth-parents.txt', 'melville-moby_dick.txt', 'milton-paradise.txt', 'shakespeare-caesar.txt', 'whitman-leaves.txt']
}	['whitman-leaves.txt']
1	['bible-kjv.txt']
1599	['shakespeare-caesar.txt']
1667	['milton-paradise.txt']
1789	['blake-poems.txt']
1816	['austen-emma.txt']
1851	['melville-moby_dick.txt']
1855	['whitman-leaves.txt']
1908	['chesterton-thursday.txt']
1909	['chesterton-ball.txt']
2	['bible-kjv.txt']
3	['bible-kjv.txt']
4	['bible-kjv.txt']
5	['bible-kjv.txt']
a	['austen-emma.txt', 'blake-poems.txt', 'chesterton-ball.txt', 'chesterton-thursday.txt', 'edgeworth-parents.txt', 'melville-moby_dick.txt', 'shakespeare-caesar.txt', 'whitman-leaves.txt']
A	['chesterton-ball.txt', 'chesterton-thursday.txt', 'shakespeare-caesar.txt']
able	['edgeworth-parents.txt']
about	['blake-poems.txt']
above	['chesterton-ball.txt']
Above	['milton-paradise.txt']
accounted	['edgeworth-parents.txt']
Actus	['shakespeare-caesar.txt']
admired	['chesterton-thursday.txt']
adventurous	['milton-paradise.txt']
affection	['austen-emma.txt']
affectionate	['austen-emma.txt']
after	['whitman-leaves.txt']
again	['blake-poems.txt']
ago	['austen-emma.txt']
aid	['milton-paradise.txt']
aimless	['chesterton-thursday.txt']
AIR	['chesterton-ball.txt']
all	['blake-poems.txt', 'melville-moby_dick.txt', 'milton-paradise.txt']
also	['chesterton-ball.txt']
am	['shakespeare-caesar.txt']
an	['austen-emma.txt']
and	['austen-emma.txt', 'bible-kjv.txt', 'blake-poems.txt', 'chesterton-ball.txt', 'chesterton-thursday.txt', 'edgeworth-parents.txt', 'melville-moby_dick.txt', 'milton-paradise.txt', 'shakespeare-caesar.txt', 'whitman-leaves.txt']
And	['bible-kjv.txt', 'blake-poems.txt']
AND	['blake-poems.txt']
announced	['chesterton-thursday.txt']
Answer	['shakespeare-caesar.txt']
antic	['chesterton-thursday.txt']
Aonian	['milton-paradise.txt']
Apparrell	['shakespeare-caesar.txt']
Apron	['shakespeare-caesar.txt']
are	['shakespeare-caesar.txt', 'whitman-leaves.txt']
arrow	['chesterton-ball.txt']
art	['chesterton-thursday.txt', 'shakespeare-caesar.txt']
as	['austen-emma.txt', 'chesterton-thursday.txt', 'edgeworth-parents.txt', 'shakespeare-caesar.txt', 'whitman-leaves.txt']
As	['edgeworth-parents.txt']
Assistant	['edgeworth-parents.txt']
at	['edgeworth-parents.txt']
Austen	['austen-emma.txt']
bad	['shakespeare-caesar.txt']
Ball	['chesterton-ball.txt']
be	['bible-kjv.txt', 'chesterton-ball.txt']
been	['austen-emma.txt']
beginning	['bible-kjv.txt', 'milton-paradise.txt']
Being	['shakespeare-caesar.txt']
Bentley	['chesterton-thursday.txt']
best	['austen-emma.txt', 'edgeworth-parents.txt', 'shakespeare-caesar.txt']
Bible	['bible-kjv.txt']
Blake	['blake-poems.txt']
bleak	['chesterton-ball.txt']
blessings	['austen-emma.txt']
blissful	['milton-paradise.txt']
blue	['chesterton-ball.txt']
body	['melville-moby_dick.txt']
Body	['whitman-leaves.txt']
book	['blake-poems.txt']
Book	['bible-kjv.txt', 'milton-paradise.txt']
BOOK	['blake-poems.txt', 'whitman-leaves.txt']
boys	['chesterton-thursday.txt']
brain	['melville-moby_dick.txt']
brook	['milton-paradise.txt']
Brought	['milton-paradise.txt']
but	['chesterton-thursday.txt', 'edgeworth-parents.txt', 'shakespeare-caesar.txt']
But	['shakespeare-caesar.txt']
by	['austen-emma.txt', 'blake-poems.txt', 'chesterton-ball.txt', 'chesterton-thursday.txt', 'edgeworth-parents.txt', 'melville-moby_dick.txt', 'milton-paradise.txt', 'shakespeare-caesar.txt', 'whitman-leaves.txt']
cabin	['edgeworth-parents.txt']
Caesar	['shakespeare-caesar.txt']
called	['bible-kjv.txt']
Called	['bible-kjv.txt']
came	['chesterton-thursday.txt']
Car	['shakespeare-caesar.txt']
caresses	['austen-emma.txt']
Carpenter	['shakespeare-caesar.txt']
castle	['edgeworth-parents.txt']
certaine	['shakespeare-caesar.txt']
chants	['whitman-leaves.txt']
Chaos	['milton-paradise.txt']
CHAPTER	['austen-emma.txt']
cheer	['blake-poems.txt']
Chesterton	['chesterton-ball.txt', 'chesterton-thursday.txt']
child	['blake-poems.txt']
children	['edgeworth-parents.txt']
chosen	['milton-paradise.txt']
clear	['blake-poems.txt']
Clerihew	['chesterton-thursday.txt']
clever	['austen-emma.txt']
cloud	['blake-poems.txt', 'chesterton-thursday.txt']
coat	['melville-moby_dick.txt']
Cob	['shakespeare-caesar.txt']
Cobl	['shakespeare-caesar.txt']
Cobler	['shakespeare-caesar.txt']
Come	['whitman-leaves.txt']
comfortable	['austen-emma.txt']
Commoners	['shakespeare-caesar.txt']
Conscience	['shakespeare-caesar.txt']
consequence	['austen-emma.txt']
Consumptive	['melville-moby_dick.txt']
could	['edgeworth-parents.txt']
created	['bible-kjv.txt']
Creatures	['shakespeare-caesar.txt']
crippled	['chesterton-thursday.txt']
Cross	['chesterton-ball.txt']
d	['blake-poems.txt', 'whitman-leaves.txt']
darkness	['bible-kjv.txt']
daughter	['edgeworth-parents.txt']
daughters	['austen-emma.txt']
day	['bible-kjv.txt', 'shakespeare-caesar.txt']
Day	['bible-kjv.txt']
death	['chesterton-thursday.txt', 'milton-paradise.txt']
decay	['chesterton-thursday.txt']
deep	['bible-kjv.txt']
Delight	['milton-paradise.txt']
Democratic	['whitman-leaves.txt']
Dick	['melville-moby_dick.txt']
didst	['milton-paradise.txt']
died	['austen-emma.txt']
directly	['shakespeare-caesar.txt']
DISCUSSION	['chesterton-ball.txt']
disobedience	['milton-paradise.txt']
disposition	['austen-emma.txt']
distress	['austen-emma.txt']
divided	['bible-kjv.txt']
do	['edgeworth-parents.txt']
dost	['shakespeare-caesar.txt']
down	['blake-poems.txt']
drone	['chesterton-thursday.txt']
Drop	['blake-poems.txt']
dust	['melville-moby_dick.txt']
dusting	['melville-moby_dick.txt']
early	['austen-emma.txt']
earth	['bible-kjv.txt', 'chesterton-ball.txt', 'milton-paradise.txt']
Earth	['whitman-leaves.txt']
Eden	['milton-paradise.txt']
Edgeworth	['edgeworth-parents.txt']
Edmund	['chesterton-thursday.txt']
eldest	['edgeworth-parents.txt']
embellished	['melville-moby_dick.txt']
Emma	['austen-emma.txt']
emptiness	['chesterton-ball.txt']
En	['whitman-leaves.txt']
ended	['chesterton-thursday.txt']
Enter	['shakespeare-caesar.txt']
ETYMOLOGY	['melville-moby_dick.txt']
evening	['bible-kjv.txt', 'chesterton-ball.txt']
ever	['melville-moby_dick.txt', 'whitman-leaves.txt']
Ever	['whitman-leaves.txt']
Every	['blake-poems.txt']
everything	['chesterton-ball.txt']
excellent	['austen-emma.txt']
existence	['austen-emma.txt']
EXPERIENCE	['blake-poems.txt']
expression	['chesterton-ball.txt']
face	['bible-kjv.txt']
faded	['chesterton-thursday.txt']
fallen	['austen-emma.txt']
far	['chesterton-ball.txt']
Fast	['milton-paradise.txt']
father	['austen-emma.txt']
fear	['chesterton-thursday.txt']
feather	['chesterton-thursday.txt']
fell	['edgeworth-parents.txt']
fine	['shakespeare-caesar.txt']
first	['bible-kjv.txt', 'milton-paradise.txt', 'whitman-leaves.txt']
First	['bible-kjv.txt']
Fla	['shakespeare-caesar.txt']
flags	['melville-moby_dick.txt']
Flauius	['shakespeare-caesar.txt']
flight	['milton-paradise.txt']
flowed	['milton-paradise.txt']
fly	['chesterton-thursday.txt']
flying	['chesterton-ball.txt']
for	['austen-emma.txt', 'chesterton-ball.txt', 'whitman-leaves.txt']
forbidden	['milton-paradise.txt']
form	['bible-kjv.txt']
four	['edgeworth-parents.txt']
from	['austen-emma.txt', 'bible-kjv.txt', 'blake-poems.txt']
fruit	['milton-paradise.txt']
G	['chesterton-ball.txt', 'chesterton-thursday.txt']
gay	['chesterton-thursday.txt', 'melville-moby_dick.txt']
Genesis	['bible-kjv.txt']
get	['shakespeare-caesar.txt']
give	['edgeworth-parents.txt']
gleaming	['chesterton-ball.txt']
glee	['blake-poems.txt']
gloom	['chesterton-thursday.txt']
God	['bible-kjv.txt', 'milton-paradise.txt']
good	['bible-kjv.txt']
governess	['austen-emma.txt']
Grammar	['melville-moby_dick.txt']
grammars	['melville-moby_dick.txt']
Grass	['whitman-leaves.txt']
greater	['milton-paradise.txt']
group	['whitman-leaves.txt']
had	['austen-emma.txt', 'chesterton-ball.txt', 'chesterton-thursday.txt']
handkerchief	['melville-moby_dick.txt']
handsome	['austen-emma.txt']
happy	['austen-emma.txt', 'blake-poems.txt']
have	['austen-emma.txt']
he	['bible-kjv.txt', 'blake-poems.txt']
He	['melville-moby_dick.txt']
hear	['blake-poems.txt']
heart	['melville-moby_dick.txt']
heaven	['bible-kjv.txt']
Heavenly	['milton-paradise.txt']
heavens	['milton-paradise.txt']
hence	['whitman-leaves.txt']
Hence	['shakespeare-caesar.txt']
her	['austen-emma.txt', 'edgeworth-parents.txt']
Her	['austen-emma.txt']
here	['whitman-leaves.txt']
Herman	['melville-moby_dick.txt']
herself	['edgeworth-parents.txt']
hill	['milton-paradise.txt']
him	['melville-moby_dick.txt']
himself	['chesterton-ball.txt']
his	['austen-emma.txt', 'melville-moby_dick.txt']
Holiday	['shakespeare-caesar.txt']
hollow	['blake-poems.txt']
home	['austen-emma.txt', 'shakespeare-caesar.txt']
hope	['shakespeare-caesar.txt']
house	['austen-emma.txt']
how	['milton-paradise.txt']
I	['austen-emma.txt', 'blake-poems.txt', 'chesterton-ball.txt', 'chesterton-thursday.txt', 'melville-moby_dick.txt', 'milton-paradise.txt', 'shakespeare-caesar.txt', 'whitman-leaves.txt']
idle	['shakespeare-caesar.txt']
if	['milton-paradise.txt']
ill	['edgeworth-parents.txt']
in	['austen-emma.txt', 'chesterton-ball.txt', 'chesterton-thursday.txt', 'edgeworth-parents.txt', 'melville-moby_dick.txt', 'milton-paradise.txt', 'shakespeare-caesar.txt', 'whitman-leaves.txt']
In	['bible-kjv.txt', 'blake-poems.txt', 'milton-paradise.txt']
IN	['chesterton-ball.txt']
indeed	['chesterton-thursday.txt', 'shakespeare-caesar.txt']
indistinct	['austen-emma.txt']
indulgent	['austen-emma.txt']
industrious	['edgeworth-parents.txt']
INNOCENCE	['blake-poems.txt']
INSCRIPTIONS	['whitman-leaves.txt']
inspire	['milton-paradise.txt']
intends	['milton-paradise.txt']
into	['milton-paradise.txt']
INTRODUCTION	['blake-poems.txt']
invented	['chesterton-ball.txt']
Invoke	['milton-paradise.txt']
Ireland	['edgeworth-parents.txt']
is	['edgeworth-parents.txt', 'shakespeare-caesar.txt']
Is	['shakespeare-caesar.txt']
it	['bible-kjv.txt', 'chesterton-ball.txt', 'edgeworth-parents.txt', 'melville-moby_dick.txt', 'milton-paradise.txt']
its	['chesterton-thursday.txt']
James	['bible-kjv.txt']
Jane	['austen-emma.txt']
John	['milton-paradise.txt']
joy	['blake-poems.txt']
Julius	['shakespeare-caesar.txt']
K	['chesterton-ball.txt', 'chesterton-thursday.txt']
keep	['whitman-leaves.txt']
King	['bible-kjv.txt']
know	['shakespeare-caesar.txt']
known	['melville-moby_dick.txt']
labouring	['shakespeare-caesar.txt']
Lamb	['blake-poems.txt']
last	['edgeworth-parents.txt']
Late	['melville-moby_dick.txt']
laughing	['blake-poems.txt']
laughter	['chesterton-thursday.txt']
Leather	['shakespeare-caesar.txt']
Leaves	['whitman-leaves.txt']
let	['whitman-leaves.txt']
Let	['bible-kjv.txt']
lexicons	['melville-moby_dick.txt']
Life	['chesterton-thursday.txt']
light	['bible-kjv.txt']
like	['chesterton-ball.txt']
Like	['chesterton-thursday.txt']
lit	['chesterton-thursday.txt']
little	['austen-emma.txt']
lived	['austen-emma.txt', 'edgeworth-parents.txt']
lock	['chesterton-thursday.txt']
long	['austen-emma.txt', 'edgeworth-parents.txt', 'whitman-leaves.txt']
loss	['milton-paradise.txt']
lost	['chesterton-thursday.txt']
Lost	['milton-paradise.txt']
loved	['melville-moby_dick.txt']
Lucifer	['chesterton-ball.txt']
Lust	['chesterton-thursday.txt']
machine	['chesterton-ball.txt']
made	['blake-poems.txt']
Man	['chesterton-thursday.txt', 'milton-paradise.txt']
Maria	['edgeworth-parents.txt']
marriage	['austen-emma.txt']
Mary	['edgeworth-parents.txt']
Masse	['whitman-leaves.txt']
mates	['whitman-leaves.txt']
may	['blake-poems.txt', 'shakespeare-caesar.txt', 'whitman-leaves.txt']
me	['blake-poems.txt', 'shakespeare-caesar.txt']
Mechanicall	['shakespeare-caesar.txt']
Melville	['melville-moby_dick.txt']
men	['chesterton-ball.txt', 'chesterton-thursday.txt']
Men	['chesterton-thursday.txt']
Mender	['shakespeare-caesar.txt']
merry	['blake-poems.txt']
middle	['milton-paradise.txt']
mildly	['melville-moby_dick.txt']
Milton	['milton-paradise.txt']
mind	['chesterton-thursday.txt']
mistress	['austen-emma.txt']
Moby	['melville-moby_dick.txt']
mockingly	['melville-moby_dick.txt']
more	['austen-emma.txt', 'milton-paradise.txt']
morning	['bible-kjv.txt']
mortal	['milton-paradise.txt']
mortality	['melville-moby_dick.txt']
Moses	['bible-kjv.txt']
most	['austen-emma.txt']
mother	['austen-emma.txt']
mount	['milton-paradise.txt']
moved	['bible-kjv.txt']
Mur	['shakespeare-caesar.txt']
Murellus	['shakespeare-caesar.txt']
Muse	['milton-paradise.txt']
my	['blake-poems.txt', 'milton-paradise.txt', 'whitman-leaves.txt']
name	['whitman-leaves.txt']
nations	['melville-moby_dick.txt']
Near	['edgeworth-parents.txt']
nearly	['austen-emma.txt', 'chesterton-ball.txt']
Night	['bible-kjv.txt']
no	['chesterton-ball.txt', 'milton-paradise.txt']
nonentity	['chesterton-thursday.txt']
not	['edgeworth-parents.txt', 'shakespeare-caesar.txt']
now	['melville-moby_dick.txt', 'whitman-leaves.txt']
obliged	['edgeworth-parents.txt']
of	['austen-emma.txt', 'bible-kjv.txt', 'blake-poems.txt', 'chesterton-ball.txt', 'chesterton-thursday.txt', 'edgeworth-parents.txt', 'melville-moby_dick.txt', 'milton-paradise.txt', 'shakespeare-caesar.txt', 'whitman-leaves.txt']
Of	['milton-paradise.txt', 'shakespeare-caesar.txt']
OF	['blake-poems.txt']
old	['chesterton-thursday.txt', 'melville-moby_dick.txt']
Old	['bible-kjv.txt']
on	['chesterton-thursday.txt', 'milton-paradise.txt', 'shakespeare-caesar.txt', 'whitman-leaves.txt']
On	['blake-poems.txt']
once	['edgeworth-parents.txt']
one	['austen-emma.txt', 'milton-paradise.txt', 'whitman-leaves.txt']
One	['whitman-leaves.txt']
or	['austen-emma.txt', 'milton-paradise.txt']
Or	['whitman-leaves.txt']
oracle	['milton-paradise.txt']
order	['chesterton-thursday.txt']
Oreb	['milton-paradise.txt']
ORPHANS	['edgeworth-parents.txt']
other	['whitman-leaves.txt']
ouer	['shakespeare-caesar.txt']
ought	['shakespeare-caesar.txt']
our	['chesterton-thursday.txt', 'milton-paradise.txt']
out	['milton-paradise.txt']
overworked	['edgeworth-parents.txt']
own	['chesterton-thursday.txt']
owning	['whitman-leaves.txt']
pale	['melville-moby_dick.txt']
Paradise	['milton-paradise.txt']
Parent	['edgeworth-parents.txt']
parish	['edgeworth-parents.txt']
pen	['blake-poems.txt']
period	['austen-emma.txt']
person	['whitman-leaves.txt']
pipe	['blake-poems.txt']
Pipe	['blake-poems.txt']
piped	['blake-poems.txt']
Piper	['blake-poems.txt']
Piping	['blake-poems.txt']
place	['austen-emma.txt']
pleas	['whitman-leaves.txt']
pleasant	['blake-poems.txt']
pluck	['blake-poems.txt']
plume	['chesterton-thursday.txt']
Poems	['blake-poems.txt']
Prima	['shakespeare-caesar.txt']
Primus	['shakespeare-caesar.txt']
Profession	['shakespeare-caesar.txt']
professor	['chesterton-ball.txt']
Professor	['chesterton-ball.txt']
prose	['milton-paradise.txt']
proudly	['chesterton-thursday.txt']
pursues	['milton-paradise.txt']
queer	['melville-moby_dick.txt']
read	['blake-poems.txt']
reed	['blake-poems.txt']
regain	['milton-paradise.txt']
remembrance	['austen-emma.txt']
reminded	['melville-moby_dick.txt']
respect	['shakespeare-caesar.txt']
Restore	['milton-paradise.txt']
resuming	['whitman-leaves.txt']
return	['whitman-leaves.txt']
rhyme	['milton-paradise.txt']
rich	['austen-emma.txt']
Rose	['milton-paradise.txt']
Rossmore	['edgeworth-parents.txt']
Round	['chesterton-thursday.txt']
ruins	['edgeworth-parents.txt']
Rule	['shakespeare-caesar.txt']
rural	['blake-poems.txt']
s	['austen-emma.txt', 'edgeworth-parents.txt', 'milton-paradise.txt', 'whitman-leaves.txt']
safe	['shakespeare-caesar.txt']
said	['bible-kjv.txt', 'blake-poems.txt', 'whitman-leaves.txt']
same	['blake-poems.txt']
sang	['blake-poems.txt', 'chesterton-ball.txt']
saw	['bible-kjv.txt', 'blake-poems.txt']
say	['shakespeare-caesar.txt']
School	['melville-moby_dick.txt']
Science	['chesterton-thursday.txt']
Scoena	['shakespeare-caesar.txt']
seat	['milton-paradise.txt']
secret	['milton-paradise.txt']
see	['melville-moby_dick.txt']
seed	['milton-paradise.txt']
seemed	['austen-emma.txt', 'chesterton-ball.txt']
self	['whitman-leaves.txt']
Self	['whitman-leaves.txt']
separate	['whitman-leaves.txt']
set	['whitman-leaves.txt']
Shakespeare	['shakespeare-caesar.txt']
shame	['chesterton-thursday.txt']
she	['edgeworth-parents.txt']
She	['austen-emma.txt']
shepherd	['milton-paradise.txt']
ship	['chesterton-ball.txt']
short	['austen-emma.txt']
should	['whitman-leaves.txt']
showed	['chesterton-thursday.txt']
sick	['chesterton-thursday.txt']
sight	['blake-poems.txt']
signe	['shakespeare-caesar.txt']
Signing	['whitman-leaves.txt']
Siloa	['milton-paradise.txt']
silver	['chesterton-ball.txt']
simple	['whitman-leaves.txt']
Sinai	['milton-paradise.txt']
sing	['whitman-leaves.txt']
Sing	['blake-poems.txt', 'milton-paradise.txt', 'whitman-leaves.txt']
Sion	['milton-paradise.txt']
sir	['shakespeare-caesar.txt']
Sir	['shakespeare-caesar.txt']
sister	['austen-emma.txt']
sit	['blake-poems.txt', 'edgeworth-parents.txt']
skies	['chesterton-ball.txt']
small	['edgeworth-parents.txt']
smile	['whitman-leaves.txt']
so	['edgeworth-parents.txt']
So	['blake-poems.txt']
soar	['milton-paradise.txt']
soil	['whitman-leaves.txt']
some	['austen-emma.txt', 'whitman-leaves.txt']
somehow	['melville-moby_dick.txt']
SOMEWHAT	['chesterton-ball.txt']
song	['blake-poems.txt', 'milton-paradise.txt']
songs	['blake-poems.txt']
SONGS	['blake-poems.txt']
soul	['chesterton-thursday.txt', 'whitman-leaves.txt']
Soul	['whitman-leaves.txt']
soules	['shakespeare-caesar.txt']
Speake	['shakespeare-caesar.txt']
spheres	['whitman-leaves.txt']
spinner	['edgeworth-parents.txt']
Spirit	['bible-kjv.txt']
Stage	['shakespeare-caesar.txt']
stain	['blake-poems.txt']
stars	['chesterton-ball.txt']
steel	['chesterton-ball.txt']
stung	['chesterton-thursday.txt']
Such	['whitman-leaves.txt']
supplied	['austen-emma.txt']
Supplied	['melville-moby_dick.txt']
Tallying	['whitman-leaves.txt']
taste	['milton-paradise.txt']
taught	['milton-paradise.txt']
Testament	['bible-kjv.txt']
th	['milton-paradise.txt']
than	['austen-emma.txt']
that	['bible-kjv.txt', 'blake-poems.txt', 'chesterton-thursday.txt', 'edgeworth-parents.txt', 'milton-paradise.txt', 'shakespeare-caesar.txt']
That	['chesterton-ball.txt', 'milton-paradise.txt', 'whitman-leaves.txt']
the	['austen-emma.txt', 'bible-kjv.txt', 'blake-poems.txt', 'chesterton-ball.txt', 'chesterton-thursday.txt', 'edgeworth-parents.txt', 'melville-moby_dick.txt', 'milton-paradise.txt', 'shakespeare-caesar.txt', 'whitman-leaves.txt']
The	['bible-kjv.txt', 'chesterton-ball.txt', 'chesterton-thursday.txt', 'edgeworth-parents.txt', 'melville-moby_dick.txt', 'shakespeare-caesar.txt']
THE	['blake-poems.txt', 'chesterton-ball.txt', 'edgeworth-parents.txt']
thee	['blake-poems.txt', 'milton-paradise.txt']
their	['chesterton-thursday.txt']
THEL	['blake-poems.txt']
them	['whitman-leaves.txt']
thence	['milton-paradise.txt']
there	['bible-kjv.txt', 'edgeworth-parents.txt']
There	['whitman-leaves.txt']
Things	['milton-paradise.txt']
this	['shakespeare-caesar.txt']
thou	['shakespeare-caesar.txt']
threadbare	['melville-moby_dick.txt']
through	['chesterton-ball.txt']
Thursday	['chesterton-thursday.txt']
thy	['blake-poems.txt', 'milton-paradise.txt', 'shakespeare-caesar.txt']
till	['milton-paradise.txt']
to	['austen-emma.txt', 'blake-poems.txt', 'chesterton-ball.txt', 'edgeworth-parents.txt', 'melville-moby_dick.txt', 'milton-paradise.txt', 'whitman-leaves.txt']
To	['chesterton-thursday.txt']
together	['chesterton-thursday.txt']
too	['austen-emma.txt']
top	['milton-paradise.txt']
Trade	['shakespeare-caesar.txt']
Tragedie	['shakespeare-caesar.txt']
tree	['milton-paradise.txt']
trees	['whitman-leaves.txt']
Truely	['shakespeare-caesar.txt']
tumultuous	['whitman-leaves.txt']
twenty	['austen-emma.txt']
two	['austen-emma.txt', 'chesterton-ball.txt']
unattempted	['milton-paradise.txt']
unite	['austen-emma.txt']
up	['edgeworth-parents.txt']
upon	['bible-kjv.txt', 'chesterton-thursday.txt']
us	['chesterton-thursday.txt', 'milton-paradise.txt', 'whitman-leaves.txt']
used	['edgeworth-parents.txt']
Usher	['melville-moby_dick.txt']
utter	['whitman-leaves.txt']
valleys	['blake-poems.txt']
vanish	['blake-poems.txt']
verses	['whitman-leaves.txt']
very	['austen-emma.txt', 'chesterton-thursday.txt', 'edgeworth-parents.txt']
vex	['austen-emma.txt']
vices	['chesterton-thursday.txt']
void	['bible-kjv.txt']
VOLUME	['austen-emma.txt']
Vpon	['shakespeare-caesar.txt']
vse	['shakespeare-caesar.txt']
wailing	['chesterton-thursday.txt']
walke	['shakespeare-caesar.txt']
Walt	['whitman-leaves.txt']
was	['austen-emma.txt', 'bible-kjv.txt', 'chesterton-ball.txt', 'chesterton-thursday.txt', 'edgeworth-parents.txt', 'melville-moby_dick.txt']
Was	['chesterton-thursday.txt']
water	['blake-poems.txt']
waters	['bible-kjv.txt']
waves	['whitman-leaves.txt']
we	['chesterton-thursday.txt', 'whitman-leaves.txt']
weather	['chesterton-thursday.txt']
went	['chesterton-thursday.txt']
wept	['blake-poems.txt']
were	['bible-kjv.txt', 'chesterton-thursday.txt']
what	['shakespeare-caesar.txt']
What	['shakespeare-caesar.txt']
wheel	['edgeworth-parents.txt']
when	['chesterton-thursday.txt']
Where	['shakespeare-caesar.txt']
which	['edgeworth-parents.txt', 'shakespeare-caesar.txt']
while	['milton-paradise.txt']
While	['blake-poems.txt']
Whistler	['chesterton-thursday.txt']
white	['chesterton-ball.txt', 'chesterton-thursday.txt']
Whitman	['whitman-leaves.txt']
who	['austen-emma.txt', 'milton-paradise.txt']
Who	['chesterton-thursday.txt']
whose	['milton-paradise.txt']
Why	['shakespeare-caesar.txt']
widow	['edgeworth-parents.txt']
wild	['blake-poems.txt']
William	['blake-poems.txt', 'shakespeare-caesar.txt']
winds	['whitman-leaves.txt']
with	['austen-emma.txt', 'blake-poems.txt', 'melville-moby_dick.txt', 'milton-paradise.txt', 'shakespeare-caesar.txt', 'whitman-leaves.txt']
With	['milton-paradise.txt']
without	['bible-kjv.txt', 'shakespeare-caesar.txt']
woe	['milton-paradise.txt']
woman	['austen-emma.txt']
Woodhouse	['austen-emma.txt']
word	['whitman-leaves.txt']
work	['edgeworth-parents.txt']
Workman	['shakespeare-caesar.txt']
world	['austen-emma.txt', 'chesterton-thursday.txt', 'melville-moby_dick.txt']
World	['milton-paradise.txt']
would	['shakespeare-caesar.txt']
write	['blake-poems.txt', 'whitman-leaves.txt']
wrote	['blake-poems.txt']
Yea	['chesterton-thursday.txt']
years	['austen-emma.txt']
yet	['milton-paradise.txt', 'whitman-leaves.txt']
Yet	['whitman-leaves.txt']
you	['chesterton-thursday.txt', 'shakespeare-caesar.txt']
You	['shakespeare-caesar.txt']
young	['chesterton-thursday.txt']
youngest	['austen-emma.txt']
your	['shakespeare-caesar.txt']
